75
75
000000000000000000000000000000000000000000000000000000000000000000000000000
000000000000000000000000000000000000000000000000000000000000000000000000000
000000000000000000000000000000000000000000000000000000000000000000000000000
000000000000000000000000000000000000000000000000000000000000000000000000000
000000000000000000000000000000000000000000000000000000000000000000000000000
000000000000000000000000000000000000000000000000000000000000000000000000000
000000000000000000000000000000000000000000000000000000000000000000000000000
000000000000000000000000000000000000000000000000000000000000000000000000000
000000000000000000000000000000000000000000000000000000000000000000000000000
000000000000000000000000000000000000000000000000000000000000000000000000000
000000000000000000000000000000000000000000000000000000000000000000000000000
000000000000000000000000000000000000000000000000000000000000000000000000000
000000000000000000000000000000000000000000000000000000000000000000000000000
000000000000000000000000000000000000000000000000000000000000000000000000000
000000000000000000000000000000000000000000000000000000000000000000000000000
000000000000000000000000000000000000000000000000000000000000000000000000000
000000000000000000000000000000000000000000000000000000000000000000000000000
000000000000000000000000000000000000000000000000000000000000000000000000000
000000000000000000000000000000000000000000000000000000000000000000000000000
000000000000000000000000000000000000000000000000000000000000000000000000000
000000000000000000000000000000000000000000000000000000000000000000000000000
000000000000000000000000000000000000000000000000000000000000000000000000000
000000000000000000000000000000000000000000000000000000000000000000000000000
000000000000000000000000000000000000000000000000000000000000000000000000000
000000000000000000000001111111111111111000000000000000000000000000000000000
000000000000000000000001111111111111111000000000000000000000000000000000000
000000000000000000000001111111111111111000000000000000000000000000000000000
000000000000000000000001111111111111111000000000000000000000000000000000000
000000000000000000000001111111111111111000000000000000000000000000000000000
000000000000000000000001111111111111111000000000000000000000000000000000000
000000000000000000000001111111111111111000000000000000000000000000000000000
000000000000000000000001111111111111111000000000000000000000000000000000000
000000000000000111111111111111111111111111111110011111111111100000000000000
000000000000000111111111111111111111111111111110011111111111100000000000100
000000000000000111111111111111111111111111111110011111111111100000000000000
000000000000000111111111111111111111111111111110011111111111100000000000000
000000000000000111111111111111111111111111111110011111111111100000000000000
000000000000000111111111111111111111111111111110011111111111100000000000000
000000000000000111111111111111111111111111111110011111111111100000000000000
000000000000000111111111111111111111111111111110011111111111100000000000000
000000000000000111111111111111111111111111111110011111111111100000000000000
000000000000000111111111111111111111111111111110011111111111100000000000000
000000000000000111111111111111111111111111111110011111111111100000000000000
000000000000000111111111111111111111111111111111111111111111100000000000000
000000000000000111111111111111111111111111111111111111111111100000000000000
000000000000000111111111111111111111111111111111111111111111100000000000000
000000000000000111111111111111111111111111111111111111111111100000000000000
000000000000000111111111111111111111111111111111111111111111100000000000000
000000000000000000000001111111111111111000000000000000000000000000000000000
000000000000000000000001111111111111111000000000000000000000000000000000000
000000000000000000000001111111111111111000000000000000000000000000000000000
000000000000000000000001111111111111111000000000000000000000000000000000000
000000000000000000000001111111111111111000000000000000000000000000000000000
000000000000000000000001111111111111111000000000000000000000000000000000000
000000000000000000000001111111111111111000000000000000000000000000000000000
000000000000000000000001111111111111111000000000000000000000000000000000000
000000000000000000000000000000000000000000000000000000000000000000000000000
000000000000000000000000000000000000000000000000000000000000000000000000000
000000000000000000000000000000000000000000000000000000000000000000000000000
000000000000000000000000000000000000000000000000000000000000000000000000000
000000000000000000000000000000000000000000000000000000000000000000000000000
000000000000000000000000000000000000000000000000000000000000000000000000000
000000000000000000000000000000000000000000000000000000000000000000000000000
000000000000000000000000000000000000000000000000000000000000000000000000000
000000000000000000000000000000000000000000000000000000000000000000000000000
000000000000000000000000000000000000000000000000000000000000000000000000000
000000000000000000000000000000000000000000000000000000000000000000000000000
000000000000000000000000000000000000000000000000000000000000000000000000000
000000000000000000000000000000000000000000000000000000000000000000000000000
000000000000000000000000000000000000000000000000000000000000000000000000000
000000000000000000000000000000000000000000000000000000000000000000000000000
000000000000000000000000000000000000000000000000000000000000000000000000000
000000000000000000000000000000000000000000000000000000000000000000000000000
000000000000000000000000000000000000000000000000000000000000000000000000000
000000000000000000000000000000000000000000000000000000000000000000000000000