20
20
00000000000000000000
00000000000000000000
00000000000000000000
00000000000000000000
00000000000000000000
00000000000000000000
00000000000000000000
00000000000000000000
00000000000000000000
00000111111000000000
00000111111100000000
00000111111100000000
00000111111100000000
00000000000000000000
00000000000000000000
00000000000000000000
00000111111110000000
00000111111110000000
00000000000000000000
00000000000000000000
00000000000000000000
