40
40
0000000000000000000000000000000000000000
0000000000000000000000000000000000000000
0000000000000111111111111111110000000000
0111111110000111111111111111110000000000
0111111110000111111111111111110000000000
0111111110000111111111111111110000000000
0111111110000111111111111111110000000000
0111111110000111111111111111110011111111
0111111110000111111111111111110011111111
0111111110000100000000000000000011111111
0111111110000100000000000000000011111111
0111111110011110000000000000000011111111
0111111110011110111111111111100011111111
0111111110011110111111111111100011111111
0000000000011110111111111111100011111111
0000000000011110111111111111100011111111
0000000000000000111111111111100011111111
0111111111111100111111111111100011111111
0111111111111100111111111111111111111111
0111111111111100111111111111100011111111
0111111111111100111111111111100011111111
0111111111111100111111111111100011111111
0111111111111100111111111111100000000000
0111111111111100111111111111101111110000
0111111111111100111111111111101111110000
0111111111111100000111100000000000000000
0111111111111100000000001111110000000000
0111111111111100111111111111111110000000
0111111111111100111111111111111110000000
0000000000000000111111111111111110000000
0000000000000000111111111111111110000000
0000000000000000111111111111111110000000
0001111111111100111111111111111110111110
0001111111111100111111111111111110111110
0001111111111100111111111111111110111110
0001111111111100111111111111111110111110
0001111111111100111111111111111110111110
0001111111111100111111111111111110111110
0001111111111100000000000000000000000000
0000000000000000000000000000000000000000
