40
40
0000000000000000000000000000000000000000
0000011111111111110000000000000000000000
0000011111111111110000000000000000000000
0000011111111111110000000000000000000000
0000011111111111111011111111110000000000
0000000000000000111011111111110000000000
0000111111111110111011111111110001111111
0000111111111110111011111111110001111111
0000111111111110111011111111110001111111
0000111111111110111011111111110001111111
0000111111111110111011111111110001111111
0000111111111110111011111111110001111111
0000111111111110111011111111110001111111
0000111111111110000011111111110001111111
0000111111111111111111111111110001111111
0000111111111111111111111111110001111111
0000111111111111111111111111110001111111
0000111111111111111111111111110001111111
0000000000111111111111111111110001111111
0000000000111111111111111111110001111111
0000000000111111111111110000000001111111
0111111000111111111111110000000001111111
0111111000111111111111110000000001111111
0111111000111111111111110001111001111111
0111111000111111111111110001111001111111
0111111000111111111111110001111001111111
0111111000111111111111110001111001111111
0111111000111111111111110001111001111111
0111111000111111111111110001111001111111
0111111000111111111111110001111001111111
0111111000111111111111110001111001111111
0111111000111111111111110001111001111111
0000000000111111111111110001111001111111
0000000000111111111111110001111001111111
0000111111000000000100000001111001111111
0000111111000000000100000000000001111111
0000111111000011111111111100000001111111
0000111111000011111111111100000001111111
0000000000000011111111111100000000000000
0000000000000000000100000000000000000000
