50
50
00000000000000000000000000000000000000000000000000
00000000000000000000000000000000000000000000000000
00000000000000000000000000000000000000000000000000
00000000000000000000000000000000000000000000000000
00000000000000000000000000000000000000000000000000
00000000000000000000000000000000000000000000000000
00000000000000000000000000000000000000000000000000
00000000000000000000000000000000000000000000000000
00000000000000000000000000000000000000000000000000
00000000000000000000000000000000000000000000000000
00000000000000000000000000000000000000000000000000
00000000000000000000000000000000000000000000000000
00000000000000000000000000000000000000000000000000
00000000000000000000000000000000000000000000000000
00000000000000000000000000000000000000000000000000
00000000000111111111111111000000000000000000000000
00000000000111111111111111000000000000000000000000
00000000000111111111111111000000000000000000000000
00000000000111111111111111000000000000000000000000
00000000000111111111111111000000000000000000000000
00000000000111111111111111000000000000000000000000
00000000000111111111111111000000000000000000000000
00000000000111111111111111000000000000000000000000
00011111111111111111111111111111110011111111111100
00011111111111111111111111111111110011111111111100
00011111111111111111111111111111110011111111111100
00011111111111111111111111111111110011111111111100
00011111111111111111111111111111110011111111111100
00011111111111111111111111111111110011111111111100
00011111111111111111111111111111110011111111111100
00011111111111111111111111111111110011111111111100
00011111111111111111111111111111110011111111111100
00011111111111111111111111111111111111111111111100
00011111111111111111111111111111111111111111111100
00011111111111111111111111111111111111111111111100
00011111111111111111111111111111111111111111111100
00011111111111111111111111111111111111111111111100
00011111111111111111111111111111111111111111111100
00011111111111111111111111111111111111111111111100
00000000000111111111111111000000000000000000000000
00000000000111111111111111000000000000000000000000
00000000000111111111111111000000000000000000000000
00000000000111111111111111000000000000000000000000
00000000000111111111111111000000000000000000000000
00000000000111111111111111000000000000000000000000
00000000000111111111111111000000000000000000000000
00000000000111111111111111000000000000000000000000
00000000000000000000000000000000000000000000000000
00000000000000000000000000000000000000000000000000
00000000000000000000000000000000000000000000000000