40
40
0000000000000000000000000011111111100000
0001100000000000000000000011111111100000
0001100000000000000000000000011111100000
0001100000000000000000000000011111100000
0001111100000000011111000000000000100000
0001111100000000011111000000011111100000
0001111100000000011111011111111111100000
0001111101100000011111011111111111100000
0001111111111111111111011100001100000000
0001111111111111111111011100001100000000
0001111111111111111111011100001100000000
0001100001100000011111011100001100000000
0001100001100000011111011111111111000000
0001100001100000011111011111111111000000
0001100001100000011111011100001100000000
0001100001100000000011011100001100000000
0001100001100000000011011100001100000000
0001100001100001110011011100001100000000
0001100001100001110011011100111111110000
0001111111111111111111011100001100000000
0001111111111111111111011100001100000000
0001100001100001110011011100001100000000
0001100001111111111111011111111111111100
0001100001111111111111011111111111111100
0001100001100001110011011100001100000000
0001100000000001110011011100001100000000
0001100000000001110011011100001100000000
0001100000000001110011011100001100000000
0001100000000001110011111100001100000000
0001100000000001110011111100001100000000
0001100011111111111111111111111111111000
0001100011111111111111111111111111111000
0001100000000001110000000000000000000000
0001100000000001110000000000000000000000
0001100000000001110000000000000000000000
0000000000000001110000000000000000000000
0000000000000001110000000000000000000000
0000000000000001110000000000000000000000
0000000000000000000000000000000000000000
0000000000000000000000000000000000000000