10
10
0000000000
0111000000
0111111110
0111111110
0111111110
0111111110
0011111110
0011111110
0000001110
0000000000