S x:50 y:50
T 00000000000000000000000000000000000000000000000000
T 00000000000000000000000000000000000000000000000000
T 00000000000000000000000000000000000000000000000000
T 00000000000000000000000000000000000000000000000000
T 00000000000000000000000000000000000000000000000000
T 00000000000000000000000000000000000000000000000000
T 00000000000000000000000000000000000000000000000000
T 00000000000000000000000000000000000000000000000000
T 00000000000000000000000000000000000000000000000000
T 00000000000001111111111111000000000000000000000000
T 00000000000001111111111111000000000000000000000000
T 00000000000001111111111111000000000000000000000000
T 00000000000001111111111111000000000000000000000000
T 00000000000001111111111111000000000000000000000000
T 00000000000001111111111111000000000000000000000000
T 00000000000001111111111111000000000000000000000000
T 00000000000001111111111111000000000000000000000000
T 00000111111111111111111111111111110011111111111000
T 00000111111111111111111111111111110011111111111000
T 00000111111111111111111111111111110011111111111000
T 00000111111111111111111111111111110011111111111000
T 00000111111111111111111111111111110011111111111000
T 00000111111111111111111111111111110011111111111000
T 00000111111111111111111111111111110011111111111000
T 00000111111111111111111111111111110011111111111000
T 00000111111111111111111111111111110011111111111000
T 00000111111111111111111111111111110011111111111000
T 00000111111111111111111111111111111111111111111000
T 00000111111111111111111111111111111111111111111000
T 00000000000001111111111111111111111111111111111000
T 00000000000001111111111111000000000000000000000000
T 00000000000001111111111111000000000000000000000000
T 00000000000001111111111111000000000000000000000000
T 00000000000001111111111111000000000000000000000000
T 00000000000001111111111111000000000000000000000000
T 00000000000001111111111111000000000000000000000000
T 00000000000001111111111111000000000000000000000000
T 00000000000000000000000000000000000000000000000000
T 00000000000000000000000000000000000000000000000000
T 00000000000000000000000000000000000000000000000000
T 00000000000000000000000000000000000000000000000000
T 00000000000000000000000000000000000000000000000000
T 00000000000000000000000000000000000000000000000000
T 00000000000000000000000000000000000000000000000000
T 00000000000000000000000000000000000000000000000000
T 00000000000000000000000000000000000000000000000000
T 00000000000000000000000000000000000000000000000000
T 00000000000000000000000000000000000000000000000000
T 00000000000000000000000000000000000000000000000000
T 00000000000000000000000000000000000000000000000000
D x:19 y:36